7 6
#S#####
#.#...E
#.#.###
#.#.#.#
#.....#
#######
